11111111111111111111111
1000000000110000000000011
1011000001110000000000001
1001000000000000000000001
11111111101100000111000001111
10000000001100000111011111111111
11110111111111011100000010001
11110111111111011101010010001
10000000110101011110000010001
  10000000000001  10000001001
 100000000000001  110100100011
11000001110101011111011110N0111
11110111 1110101 101111010001
1111111111111111 111111111111111