
NO ./textures/wall_bricks_red.xpm

SO ./textures/wall_bricks_teal.xpm


WE ./textures/wall_bricks_blue.xpm
EA ./textures/wall_bricks_green.xpm


F 0,   0,  0
C                194,223,250



11111111  1111111111111111111
11000000111111111111111111111
1011000001110000000000001
1001000000000000000000001
11111111101100000111000001111
10000000001100000111011111111111
1110111111111011100000010001
11110111111111011101010010001
11000000110101011110000010001
  10000000000001  10000001001
 100000000000001  110100100011
110000011101010111110111100111
11110111 1110101 10111101000S1
1111111111111111 111111111111